"a" = (/obj/structure/window/reinforced{dir = 8},/obj/structure/window/reinforced{dir = 1; layer = 2.9},/turf/open/floor/engine,/area/shuttle/vault_elevator)
"b" = (/turf/open/floor/engine,/area/shuttle/vault_elevator)
"c" = (/obj/structure/window/reinforced{dir = 1; layer = 2.9},/turf/open/floor/engine,/area/shuttle/vault_elevator)
"d" = (/obj/structure/window/reinforced{dir = 4},/obj/structure/window/reinforced{dir = 1; layer = 2.9},/turf/open/floor/engine,/area/shuttle/vault_elevator)
"e" = (/obj/structure/window/reinforced{dir = 4},/turf/open/floor/engine,/area/shuttle/vault_elevator)
"f" = (/obj/structure/window/reinforced{dir = 8},/turf/open/floor/engine,/area/shuttle/vault_elevator)
"g" = (/obj/structure/window/reinforced,/obj/structure/window/reinforced{dir = 8},/turf/open/floor/engine,/area/shuttle/vault_elevator)
"h" = (/obj/docking_port/mobile/elevator{id = "enclave_fort_elevator"; name = "enclave fort elevator"; timid = 1; width = 3},/turf/open/floor/engine,/area/shuttle/vault_elevator)
"i" = (/obj/machinery/computer/shuttle/enclavefortelevator{icon_state = "computer"; dir = 1},/obj/structure/window/reinforced{dir = 4},/obj/structure/window/reinforced,/turf/open/floor/engine,/area/shuttle/vault_elevator)

(1,1,1) = {"
accd
fbbe
gbhi
"}
